************************************
*--------***************************
********-----------*****-----------*
********-***************-***********
**-----------------------***********
**-****-***********-****************
*--****-***********---------------**
*******-*-************-**********--*
*******---************-*************
**********************------------**
*********************************-**
************************************

